1111111111111111111111111111
1DDDDDXDDDDDD11DDDDDDXDDDDD1
1D1111D11111D11D11111D1111D1
1E1111D11111D11D11111D1111E1
1D1111D11111D11D11111D1111D1
1XDDDDXDDXDDXDDXDDXDDXDDDDX1
1D1111D11D11111111D11D1111D1
1D1111D11D11111111D11D1111D1
1DDDDDX11DDDD11DDDD11XDDDDD1
111111D11111011011111D111111
000001D11111011011111D100000
000001D11000K0BK00011D100000
000001D110111GG111011D100000
000001D110100KK001011D100000
000001X00K10I0P0C1K00X100000
000001D11010000001011D100000
000001D11011111111011D100000
000001D11K00000000K11D100000
000001D11011111111011D100000
111111D11011111111011D111111
1DDDDDXDDXDDD11DDDXDDXDDDDD1
1D1111D11111D11D11111D1111D1
1D1111D11111D11D11111D1111D1
1EDD11XDDXDDX0MXDDXDDX11DDE1
111D11D11D11111111D11D11D111
111D11D11D11111111D11D11D111
1DDXDDD11DDDD11DDDD11DDDXDD1
1D1111111111D11D1111111111D1
1D1111111111D11D1111111111D1
1DDDDDDDDDDDXDDXDDDDDDDDDDD1
1111111111111111111111111111
